8
0 0 0 -1 0 1 3 0
1 0 1 -1 1 2 1 0
2 0 2 10 2 2 4 1
3 1 0 -1 0 3 5 3
4 1 2 -1 2 4 7 4
5 2 0 -1 3 6 5 5
6 2 1 -1 6 7 6 5
7 2 2 -1 4 7 7 6