12
0 0 3 -1 0 0 3 0
1 1 1 -1 1 2 5 1
2 1 2 -1 2 3 2 1
3 1 3 -1 0 4 6 2
4 1 4 -1 4 4 4 3
5 2 1 -1 1 5 8 5
6 2 3 -1 3 6 10 6
7 3 0 -1 7 8 7 7
8 3 1 -1 5 9 8 7
9 3 2 10 9 10 9 8
10 3 3 -1 6 10 11 9
11 4 3 -1 10 11 11 11